0E0E
0101010101010101010101010101
0100000000000000000000000001
010000A000000000000000000001
0100000000000000000000000001
0100000000000000000000000001
0100000000000200000000000001
010000000000040000000000A001
0100000000000500030000000001
0100000000000600000000000001
0100000000000000000000000001
01000A0000000000000000000001
0100000000000000000000000001
0100000000000000000000000001
0101010101010101010101010101
FFFF