1414
010101010101010101010101010101
010000000000000000000000000001
010000000000000000000000000001
010000000000000000000000000001
010000000000000000000000000001
010000000000000000000000000001
010000000000000000000000000001
010000000000000000000000000001
010000000000000000000000000001
010000000000000000000000000001
01000A000000000000000000000001
010000000000000000000000000001
010000000000000000000000000001
010000000000000000000000000001
010000000000000000000000000001
010000000000000000000000000001
010000000000000000000000000001
010000000000000000000000000001
010000000000000000000000000001
010101010101010101010101010101
FFFF
